1111111111111
1P0100000C001
100C011011001
100001E000001
1111111111111